######S########
###### ########
######    #####
###### ## #####
######        E
###############